#ABC MAPS FILE CONTENT WITH TILES TYPES

1->START
TTTTTTTT
TPPPPPPT
TPPPPPPT
TPPPPPPT
TPPPPPPT
TPPPPPPT
TPPPPPPT
TTTTTTTT
1->STOP

2->START
MMMMMMMM
MPPPPPPM
MPPPPPPM
MPPPPPPM
MPPPPPPM
MPPPPPPM
MPPPPPPM
MMMMMMMM
2->STOP
